# Booster sets
# Series 1
Vol.1	XXXX	1
Vol.2	(OCG-JP)	1
Vol.3	(OCG-JP)	1
Vol.4	(OCG-JP)	1
Vol.5	(OCG-JP)	1
Vol.7	(OCG-JP)	1
Booster 1	XXXX	1
Booster 2	(OCG-JP)	1
Booster 3	(OCG-JP)	1
Booster 4	(OCG-JP)	1
Booster 5	(OCG-JP)	1
Booster 6	(OCG-JP)	1
Booster 7	(OCG-JP)	1
# Series 2
Magic Ruler	(OCG-JP)	2
Pharoah's Servant	(OCG-JP)	2
Curse of Anubis	(OCG-JP)	2
Thousand Eyes Bible	(OCG-JP)	2
Spell of Mask	(OCG-JP)	2
Labyrinth of Nightmare	(OCG-JP)	2
Struggle of Chaos	(OCG-JP)	2
Mythological Age	(OCG-JP)	2
Pharaonic Guardian	(OCG-JP)	2
# Series 3
The New Ruler	(OCG-JP)	2
Advent of Union	(OCG-JP)	2
Champion of Black Magic	(OCG-JP)	2
Power of the Guardian	(OCG-JP)	2
Threat of the Dark Demon World	(OCG-JP)	2
Controller of Chaos	(OCG-JP)	2
Invader of Darkness	(OCG-JP)	2
The Sanctuary in the Sky	(OCG-JP)	2
Pharaoh's Inheritance	(OCG-JP)	2
# International Series 3
Legend of Blue Eyes White Dragon	(TCG-EN)	0
Metal Raiders	(TCG-EN)	0
Spell Ruler	(TCG-EN)	0
Pharaoh%27s Servant	(TCG-EN)	0
Labyrinth of Nightmare	(TCG-EN)	0
Legacy of Darkness	(TCG-EN)	0
Pharaonic Guardian	(TCG-EN)	0
Magician%27s Force	(TCG-EN)	0
Dark Crisis	(TCG-EN)	0
Invasion of Chaos	(TCG-EN)	0
Ancient Sanctuary 	(TCG-NA)	0
# Series 4
Soul of the Duelist	(TCG-EN)	0
Rise of Destiny	(TCG-EN)	0
Flaming Eternity	(TCG-EN)	0
The Lost Millennium	(TCG-EN)	0
Cybernetic Revolution	(TCG-EN)	0
Elemental Energy	(TCG-EN)	0
Shadow of Infinity	(TCG-EN)	0
Enemy of Justice	(TCG-EN)	0
# Series 5
Power of the Duelist	(TCG-EN)	0
Cyberdark Impact	(TCG-EN)	0
Strike of Neos	(TCG-EN)	0
Force of the Breaker	(TCG-EN)	0
Tactical Evolution	(TCG-EN)	0
Gladiator%27s Assault	(TCG-EN)	0
Phantom Darkness	(TCG-EN)	0
Light of Destruction	(TCG-EN)	0
# Series 6
The Duelist Genesis	(TCG-EN)	0
Crossroads of Chaos	(TCG-EN)	0
Crimson Crisis	(TCG-EN)	0
Raging Battle	(TCG-EN)	0
Ancient Prophecy	(TCG-EN)	0
Stardust Overdrive	(TCG-EN)	0
Absolute Powerforce	(TCG-EN)	0
The Shining Darkness	(TCG-EN)	0
# Series 7
Duelist Revolution	(TCG-EN)	0
Starstrike Blast	(TCG-EN)	0
Storm of Ragnarok	(TCG-EN)	0
Extreme Victory	(TCG-EN)	0
Generation Force	(TCG-EN)	0
Photon Shockwave	(TCG-EN)	0
Order of Chaos	(TCG-EN)	0
Galactic Overlord	(TCG-EN)	0
# Series 8
Return of the Duelist	(TCG-EN)	0
Abyss Rising	(TCG-EN)	0
Cosmo Blazer	(TCG-EN)	0
Lord of the Tachyon Galaxy	(TCG-EN)	0
Judgment of the Light	(TCG-EN)	0
Shadow Specters	(TCG-EN)	0
Legacy of the Valiant	(TCG-EN)	0
Primal Origin	(TCG-EN)	0
# Reprint Sets
Legend of Blue Eyes White Dragon	(OCG-JP)	2
Phantom God	(OCG-JP)	2
Revival of Black Demons Dragon	(OCG-JP)	2
Metal Raiders	(OCG-JP)	2
Booster R1	(OCG-JP)	2
Booster R2	(OCG-JP)	2
Booster R3	(OCG-JP)	2
Booster Chronicle	(OCG-JP)	2
Duelist Legacy Volume.1	(OCG-JP)	2
Duelist Legacy Volume.2	(OCG-JP)	2
Duelist Legacy Volume.3	(OCG-JP)	2
Duelist Legacy Volume.4	(OCG-JP)	2
Duelist Legacy Volume.5	(OCG-JP)	2
Beginner's Edition.1	(OCG-JP)	2
Beginner's Edition.2	(OCG-JP)	2
# Expert Edition Volume.1
# Expert Edition Volume.2
Expert Edition Volume.3	(OCG-JP)	2
Expert Edition Volume.4	(OCG-JP)	2
Beginner's Edition (2011)	(OCG-JP)	2
Beginner's Edition 2 (2011)	(OCG-JP)	2
Duelist Edition Volume 1	(OCG-JP)	2
Duelist Edition Volume 2	(OCG-JP)	2
Duelist Edition Volume 3	(OCG-JP)	2
Duelist Edition Volume 4	(OCG-JP)	2
Precious Pack Volume 1	(OCG-KR)	2
Precious Pack Volume 2	(OCG-KR)	2
Dark Beginning 1	(TCG-EN)	0
Dark Beginning 2	(TCG-EN)	0
Dark Revelation Volume 1	(TCG-EN)	0
Dark Revelation Volume 2	(TCG-EN)	0
Dark Revelation Volume 3	(TCG-EN)	0
Dark Revelation Volume 4	(TCG-EN)	0
Retro Pack	(TCG-EN)	0
Retro Pack 2	(TCG-EN)	0
Dark Legends	(TCG-EN)	0
# Battle Packs
Battle Pack: Epic Dawn	(TCG-EN)	0
Battle Pack 2: War of the Giants	(TCG-EN)	0
Battle Pack 2: War of the Giants - Round 2	(TCG-EN)	0
War of the Giants Reinforcements	(TCG-EN)	0
Battle Pack 3: Monster League	(TCG-EN)	0
# Duelist Packs
Duelist Pack: Jaden Yuki	(TCG-EN)	0
Duelist Pack: Chazz Princeton	(TCG-EN)	0
Duelist Pack: Jaden Yuki 2	(TCG-EN)	0
Duelist Pack: Zane Truesdale	(TCG-EN)	0
Duelist Pack: Aster Phoenix	(TCG-EN)	0
Duelist Pack: Jaden Yuki 3	(TCG-EN)	0
Duelist Pack: Jesse Anderson	(TCG-EN)	0
Duelist Pack: Yusei	(TCG-EN)	0
Duelist Pack: Yugi	(TCG-EN)	0
Duelist Pack: Yusei 2	(TCG-EN)	0
Duelist Pack: Kaiba	(TCG-EN)	0
Duelist Pack: Yusei 3	(TCG-EN)	0
Duelist Pack: Crow	(TCG-EN)	0
Duelist Pack: Yuma	(OCG-JP)	2
Duelist Pack: Kite	(OCG-JP)	2
Duelist Pack: Yuma 2: Gogogo %26 Dododo	(OCG-JP)	2
Duelist Pack: Kastle Siblings	(OCG-JP)	2
# Extra Packs
Extra Pack	(OCG-JP)	2
Extra Pack Volume 2	(OCG-JP)	2
Extra Pack Volume 3	(OCG-JP)	2
Extra Pack Volume 4	(OCG-JP)	2
Extra Pack 2012	(OCG-JP)	2
Extra Pack: Sword of Knights	(OCG-JP)	2
# Gold Series
Gold Series	(TCG-EN)	0
Gold Series 2009	(TCG-EN)	0
Gold Series 3	(TCG-EN)	0
Gold Series 4: Pyramids Edition	(TCG-EN)	0
Gold Series: Haunted Mine	(TCG-EN)	0
Premium Gold	(TCG-EN)	0
# Hidden Arsenal
Hidden Arsenal	(TCG-EN)	0
Hidden Arsenal 2	(TCG-EN)	0
Hidden Arsenal 3	(TCG-EN)	0
Hidden Arsenal 4: Trishula%27s Triumph	(TCG-EN)	0
Hidden Arsenal 5: Steelswarm Invasion	(TCG-EN)	0
Hidden Arsenal 6: Omega Xyz	(TCG-EN)	0
Hidden Arsenal 7: Knight of Stars	(TCG-EN)	0
# Mega Pack
Ra Yellow Mega-Pack	(TCG-EN)	0
Legendary Collection 2 Mega-Pack	(TCG-EN)	0
Legendary Collection 3 Mega-Pack	(TCG-EN)	0
Legendary Collection 4 Mega-Pack	(TCG-EN)	0
# Premium Packs
Premium Pack	(TCG-EN)	0
Premium Pack 2	(TCG-EN)	0
# Other
Anniversary Pack	(TCG-EN)	0
Booster SP: Raging Masters	(OCG-JP)	2
Number Hunters	(TCG-EN)	0
Dragons of Legend	(TCG-EN)	0
Deck Custom Pack 01	(OCG-JP)	2
Demo Pack	(TCG-EN)	0
Duelist Set: Version Machine-Gear Troopers Enhancement Pack	(OCG-JP)	2
Duelist Set: Version Lightlord Judgment Enhancement Pack	(OCG-JP)	2
Exclusive Pack	(TCG-EN)	0
Movie Pack	(TCG-EN)	0
Yu-Gi-Oh! 3D Bonds Beyond Time Movie Pack	(TCG-EN)	0
Starter Deck: Yugi	 (TCG-SP)	0
Star Pack 2013	(TCG-EN)	0
Star Pack 2014	(TCG-EN)	0
Starter Deck 2013 Enhancement Pack	(OCG-JP)	2
Starter Deck 2014 Enhancement Pack	(OCG-JP)	2
Super Starter Power-Up Pack	(TCG-EN)	0
Space-Time Showdown Power-Up Pack	(TCG-EN)	0
Starter Pack Volume 1 	(OCG-TC)	2
World Championship 2010 Card Pack	(TCG-EN)	0
World Championship 2011 Card Pack	(TCG-EN)	0
# Starter decks
Starter Box	(OCG-JP)	1
Starter Box: Theatrical Release	(OCG-JP)	1
EX Starter Box	(OCG-JP)	1
EX-R Starter Box	(OCG-JP)	2
Starter Deck: Yugi 	(TCG-NA)	0
Starter Deck: Kaiba 	(TCG-NA)	0
Starter Deck: Joey		(TCG-EN)	0
Starter Deck: Pegasus 	(TCG-NA)	0
Starter Deck: Yugi Evolution	(TCG-EN)	0
Starter Deck: Kaiba Evolution	(TCG-EN)	0
Starter Deck: Jaden Yuki	(TCG-EN)	0
Starter Deck: Syrus Truesdale	(TCG-EN)	0
Starter Deck: Yugi Reloaded	(TCG-EN)	0
Starter Deck: Kaiba Reloaded	(TCG-EN)	0
Starter Deck 2006	(TCG-EN)	0
Starter Deck: Yu-Gi-Oh! 5D%27s	(TCG-EN)	0
Starter Deck: Yu-Gi-Oh! 5D%27s 2009	(TCG-EN)	0
Starter Deck: Duelist Toolbox	(TCG-EN)	0
Starter Deck: Dawn of the Xyz	(TCG-EN)	0
Starter Deck: Xyz Symphony	(TCG-EN)	0
Super Starter: V for Victory	(TCG-EN)	0
Super Starter: Space-Time Showdown	(TCG-EN)	0
# Structure Decks
Structure Deck: Yugi	(OCG-JP)	2
Structure Deck: Joey	(OCG-JP)	2
Structure Deck: Kaiba	(OCG-JP)	2
Structure Deck: Pegasus	(OCG-JP)	2
Structure Deck: Yugi Volume 2	(OCG-JP)	2
Structure Deck: Joey Volume 2	(OCG-JP)	2
Structure Deck: Kaiba Volume 2	(OCG-JP)	2
Structure Deck: Marik	(OCG-JP)	2
Structure Deck: Dragon%27s Roar	(TCG-EN)	0
Structure Deck: Zombie Madness	(TCG-EN)	0
Structure Deck: Blaze of Destruction	(TCG-EN)	0
Structure Deck: Fury from the Deep	(TCG-EN)	0
Structure Deck: Warrior%27s Triumph	(TCG-EN)	0
Structure Deck: Spellcaster%27s Judgment	(TCG-EN)	0
Structure Deck: Invincible Fortress	(TCG-EN)	0
Structure Deck: Lord of the Storm	(TCG-EN)	0
Structure Deck: Dinosaur%27s Rage	(TCG-EN)	0
Structure Deck: Machine Re-Volt	(TCG-EN)	0
Rise of the Dragon Lords Structure Deck	(TCG-EN)	0
The Dark Emperor Structure Deck	(TCG-EN)	0
Zombie World Structure Deck	(TCG-EN)	0
Spellcaster%27s Command Structure Deck	(TCG-EN)	0
Warriors%27 Strike Structure Deck	(TCG-EN)	0
Machina Mayhem Structure Deck	(TCG-EN)	0
Structure Deck: Marik	(TCG-EN)	0
Dragunity Legion Structure Deck	(TCG-EN)	0
Lost Sanctuary Structure Deck	(TCG-EN)	0
Gates of the Underworld Structure Deck	(TCG-EN)	0
Dragons Collide Structure Deck	(TCG-EN)	0
Samurai Warlords Structure Deck	(TCG-EN)	0
Realm of the Sea Emperor Structure Deck	(TCG-EN)	0
Onslaught of the Fire Kings Structure Deck	(TCG-EN)	0
Saga of Blue-Eyes White Dragon Structure Deck	(TCG-EN)	0
Cyber Dragon Revolution Structure Deck	(TCG-EN)	0
Realm of Light Structure Deck	(TCG-EN)	0
# Duel Terminals
Duel Terminal - Preview	(TCG-EN)	0
Duel Terminal 1	(TCG-EN)	0
Duel Terminal 2	(TCG-EN)	0
Duel Terminal 3	(TCG-EN)	0
Duel Terminal 4	(TCG-EN)	0
Duel Terminal 5	(TCG-EN)	0
Duel Terminal 6	(TCG-EN)	0
Duel Terminal 7	(TCG-EN)	0
# Promotional
Yu-Gi-Oh! Character Guidebook: The Gospel of Truth promotional cards	(OCG-JP)	2
Master Guide promotional cards	(OCG-JP)	2
Master Guide 2 promotional cards	(OCG-JP)	2
Master Guide 4 promotional cards	(OCG-JP)	2
Numbers Guide promotional card	(OCG-JP)	2
Numbers Guide 2 promotional card	(OCG-JP)	2
Numbers Guide 3 promotional card	(OCG-JP)	2
# Official Guide Starter Book
# The Thousand Rule Bible
The Valuable Book promotional cards	(OCG-JP)	2
Primal Origin Booster Pack Guide promotional card	(OCG-JP)	2
Perfect Rulebook promotional card	(OCG-JP)	2
# Boost Pack Tin Series Promos
2002 Booster Pack Tins 	(TCG-NA)	0
2003 Booster Pack Tins 	(TCG-NA)	0
# 2004 Collector Tins
2005 Collector Tins	(TCG-EN)	0
# 2006 Collector Tins
# 2007 Collector Tins
# 2008 Collector Tins
# 2009 Collector Tins
# 2010 Collector Tins
Collectible Tins 2011 Wave 1	(TCG-EN)	0
Collectible Tins 2011 Wave 2	(TCG-EN)	0
Collectible Tins 2012 Wave 1	(TCG-EN)	0
Collectible Tins 2012 Wave 2	(TCG-EN)	0
Collectible Tins 2012 Wave 2.5	(TCG-EN)	0
Collectible Tins 2013 Wave 1	(TCG-EN)	0
Collectible Tins 2013 Wave 2	(TCG-EN)	0
Duelist Pack Collection	(OCG-JP)	2
Duelist Pack Collection Tin 2008	(TCG-EN)	0
Duelist Pack Collection Tin: Jaden Yuki	(TCG-EN)	0
Duelist Pack Collection Tin 2009	(TCG-EN)	0
Duelist Pack Collection Tin 2010	(TCG-EN)	0
Duelist Pack Collection Tin 2011	(TCG-EN)	0
Master Collection Volume 1	(TCG-EN)	0
Master Collection Volume 2	(TCG-EN)	0
Master Collection Volume 3	(OCG-JP)	2
Collectors Tin 2009	(OCG-JP)	2
Exclusive Tins 2008	(TCG-EN)	0
Exclusive Tins 2009	(TCG-EN)	0
Premium Collection Tin	(TCG-EN)	0
2013 Zexal Collection Tin	(TCG-EN)	0
# Dark Duel Stories Game Guide 1 Promos
# Dark Duel Stories Game Guide 2 Promos
# Tri Holy God Advent Game Guide 1 Promos
# Tri Holy God Advent Game Guide 2 Promos
# Battle of Great Duelist Game Guide 1 Promos
# Battle of Great Duelist Game Guide 2 Promos
# Expert 1 Game Guide 1 Promos
# Expert 2 Game Guide 1 Promos
# Expert 2 Game Guide 2 Promos
# The Duel City Legend Game Guide 1 Promos
# The Duel City Legend Game Guide 2 Promos
# Reshef of Destruction Game Guide 1 Promos
# Reshef of Destruction Game Guide 2 Promos
# Expert 3 Game Guide Promos
# Sealed Memories Game Guide Promos
# Succeeded Memories Game Guide Promos
# Stairway to the Destined Duel Game Guide
# World Championship 2008 Game Guide
# World Championship 2001 Over the Nexus Strategy Guide
Yu-Gi-Oh! Capsule Monster Coliseum Guide Book promotional card	(OCG-JP)	2
# Duel Terminal Acceleration Guide promotional card
# Duel Terminal Acceleration Guide 2 promotional card
# Duel Terminal Acceleration Guide 3 promotional card
# Duel Terminal Acceleration Guide 4 promotional card
# Duel Terminal Acceleration Guide 5 promotional card
# Duel Terminal Overlay Guide Promotional Card
# Duel Terminal Overlay Guide 2 Promotional Card
Yu-Gi-Oh! ZEXAL World Duel Carnival Duel Champion Guide! promotional card	(OCG-JP)	2
Legendary Collection	(TCG-EN)	0
Legendary Collection 2: The Duel Academy Years	(TCG-EN)	0
Legendary Binder	(OCG-KR)	2
Legendary Collection 3: Yugi's World	(TCG-EN)	0
Legendary Collection 4: Joey's World	(TCG-EN)	0
# Banzai! promotional cards
# Jump Heroes promotional card
# Saikyo Jump promotional card
Shonen Jump promotional cards	(TCG-EN)	0
V Jump promotional cards	(OCG-JP)	2
# V Jump 1999 promotional cards
Weekly Shōnen Jump promotional cards	(OCG-JP)	2
Yu-Gi-Oh! The Official Magazine promotional cards	(TCG-IT)	2
# Yu-Gi-Oh! Volume 31 promotional card
# Yu-Gi-Oh! Duelist Volume 16 promotional card
# Yu-Gi-Oh! Millennium World Volume 4 promotional card
Yu-Gi-Oh! R promotional cards	(TCG-EN)	0
Yu-Gi-Oh! GX manga promotional cards	(TCG-EN)	0
Yu-Gi-Oh! 5D's manga promotional cards	(TCG-EN)	0
Yu-Gi-Oh! ZEXAL Volume 1 promotional card	(TCG_EN)	0
Yu-Gi-Oh! ZEXAL Volume 2 promotional card	(TCG_EN)	0
Yu-Gi-Oh! ZEXAL Volume 3 promotional card	(TCG_EN)	0
Yu-Gi-Oh! ZEXAL Volume 4 promotional card	(TCG_EN)	0
Yu-Gi-Oh! ZEXAL Volume 5 promotional card	(TCG_EN)	0
Yu-Gi-Oh! ZEXAL Volume 6 promotional card	(TCG_EN)	0
Yu-Gi-Oh! ZEXAL Volume 7 promotional card	(TCG_EN)	0
# Yu-Gi-Oh! The Movie Ani-Manga promotional card
# Asian Tournament Promos 1999
# Asian Tournament Promos 2000
# Asian Tournament Promos 2001
# Attack of the Giant Card!!
# Battle Pack Tournament Prize Cards
Concept Duel 1	(OCG-JP)	0
Concept Duel 2	(OCG-JP)	0
Concept Duel 3	(OCG-JP)	0
# Custom Token Card
# Duel Monsters II tournament meeting experience promotional card
Duelist League 1 participation cards	(TCG-EN)	0
Duelist League 2 participation cards	(TCG-EN)	0
Duelist League 3 participation cards	(TCG-EN)	0
Duelist League 4 participation cards	(TCG-EN)	0
Duelist League 5 participation cards	(TCG-EN)	0
Duelist League 6 participation cards	(TCG-EN)	0
Duelist League 7 participation cards	(TCG-EN)	0
Duelist League 8 participation cards	(TCG-EN)	0
Duelist League 8 participation cards	(TCG-EN)	0
Duelist League 10 participation cards	(TCG-EN)	0
Duelist League 11 participation cards	(TCG-EN)	0
Duelist League 12 participation cards	(TCG-EN)	0
Duelist League 13 participation cards	(TCG-EN)	0
Duelist League 14 participation cards	(TCG-EN)	0
Duelist League 15 participation cards	(TCG-EN)	0
Duelist League 16 participation cards	(TCG-EN)	0
Duelist League 17 participation cards	(TCG-EN)	0
Duelist League 18 participation cards	(TCG-EN)	0
Hobby League Participation Cards	(TCG-EN)	0
# Jump Festa 2000
# Jump Festa 2006
# Jump Festa 2007
# Jump Festa 2008
# Jump Festa Anime Tour 2008
# 5D's National Championship 2009 promotional cards
Jump Festa Invitational 2009	(OCG-KR)	2
Spring Battle 2010	(OCG-KR)	2
National Championship 2010 TOP 8	(OCG-KR)	2
Summer Festival 2010	(OCG-KR)	2
Jump Festa Invitational 2010	(OCG-KR)	2
Winter Festival 2010	(OCG-KR)	2
Spring Battle 2011	(OCG-KR)	2
National Championship 2011	(OCG-KR)	2
Summer Festival 2011	(OCG-KR)	2
Winter Festival 2011	(OCG-KR)	2
Spring Battle 2012	(OCG-KR)	2
National Championship 2012	(OCG-KR)	2
Summer Festival 2012	(OCG-KR)	2
Winter Festival 2012	(OCG-KR)	2
National Championship 2013	(OCG-KR)	2
Spring Battle 2013	(OCG-KR)	2
# Yu-Gi-Oh! National Championship Prize Cards
# Pharaoh's Tour Championship Prize Cards
# San Diego Comic-Con Promotional Cards
Shonen Jump Championship Series Prize Cards	(TCG-EN)	0
# Starter Deck 2008 Tournament Promotional Cards
# Yu-Gi-Oh! Summer Challenge 2009 Promotional Cards
# 2009 Event Token Promos
# Yu-Gi-Oh! Trading Card Game Tour 2004 Promotional Card
# Toys "R" Us Tournament Promos
# Toys "R" Us Throwdown Promos
# World Championship Series promotional cards
# World Ranking Promos: Series 1
# World Ranking Promos: Series 2
# World Ranking Promos: Series 3
# World Ranking Promos: Series 4
# World Ranking Promos: Series 5
# World Ranking Promos: Series 6
# World Ranking Promos: Series 7
# World Ranking Promos: Series 8
# World Ranking Promos: Series 9
# V Jump Festa promotional cards
Yu-Gi-Oh! Championship Series 2010 Prize Cards	(TCG-EN)	0
Yu-Gi-Oh! Championship Series 2011 Prize Card	(TCG-EN)	0
Yu-Gi-Oh! Championship Series 2012 Prize Card	(TCG-EN)	0
Mattel Action Figure Promotional Cards	(TCG-EN)	0
# Duel Disk Promos: Series 1
# Duel Disk Promos: Series 2
# Academy Duel Disk promotional card
# Academy Duel Disk Special Edition promos
# Academy Duel Disk Osiris Red promos
# Duel Disk - Yusei Version
Duel Disk - Yusei Version DX	(OCG-JP)	2
# Duel Disk - Yusei Version 2010
# Monster Figure Collection
# Monster Figure Collection 2
# Monster Figure Collection 3
# Startdust Overdrive Plus
Prinal Original Plus	(TCG-EN)	0
# Continuous Token Gifts
# Duel Art Campaign
Half Deck: Dark	(OCG-JP)	2
Half Deck: Light	(OCG-JP)	2
Movie promotional card	(OCG-JP)	2
# Starter Box pre-order promotional card
# Beginners Pack
Duelist Playmat Edition	(OCG-KR)	2
Duel Master's Guide	(TCG-NA)	0
Duelist Card Playmat	XXXX	2
Duelist Card Protector EX: Shadow of the Six Samurai - Shien	XXXX	2
Duelist Card Protector EX: Ghostrick	XXXX	2
Duelist Card Protector EX: Bujintei Susanowo	(OCG-JP)	2
Duelist Card Protector EX: Master of HERO	(OCG-JP)	2
Forbidden Legacy	(TCG-EN)	0
# GX Next Generation Blister Pack Promo
# Make-A-Wish Foundation promotional card
McDonald's Promotional Cards: Series 1	(TCG-EN)	0
McDonald's Promotional Cards: Series 2	(TCG-EN)	0
# Advent Calendar
# 10th Anniversary Movie Promo
Invasion of Chaos: Special Edition	(TCG-NA)	0
Rise of Destiny: Special Edition	(TCG-EN)	0
The Lost Millennium: Special Edition	(TCG-EN)	0
# Elemental Energy: Special Edition
# Shadow of Infinity: Special Edition
# Strike of Neos: Special Edition
Force of the Breaker: Special Edition Promos	(TCG-EN)	0
Tactical Evolution: Special Edition	(TCG-EN)	0
Gladiator's Assault: Special Edition	(TCG-EN)	0
Phantom Darkness: Special Edition	(TCG-EN)	0
Light of Destruction: Special Edition	(TCG-EN)	0
The Duelist Genesis: Special Edition	(TCG-EN)	0
Crossroads of Chaos: Special Edition	(TCG-EN)	0
Crimson Crisis: Special Edition	(TCG-EN)	0
# Raging Battle: Special Edition
Ancient Prophecy: Special Edition	(TCG-EN)	0
# Stardust Overdrive: Special Edition
# Absolute Powerforce: Special Edition
# Duelist Revolution: Special Edition
Storm of Ragnarok: Special Edition	(TCG-EN)	0
# Hidden Arsenal: Special Edition
Generation Force: Special Edition	(TCG-EN)	0
Order of Chaos: Special Edition	(TCG-EN)	0
# Hidden Arsenal 5: Steelswarm Invasion: Special Edition
# Ra Yellow Mega-Pack: Special Edition
Return of the Duelist: Special Edition	(TCG-EN)	0
Abyss Rising: Special Edition	(TCG-EN)	0
Cosmo Blazer: Special Edition	(TCG-EN)	0
Judgment of the Light: Special Edition	(TCG-EN)	0
Shadow Specters: Special Edition	(TCG-EN)	0
Legacy of the Valiant: Deluxe Edition	(TCG-EN)	0
Primal Origin: Deluxe Edition	(TCG-EN)	0
Duelist Packs: Special Edition	(TCG-EN)	0
# Duelist Pack: Zane Truesdale Special Edition
# Duelist Pack: Aster Phoenix Special Edition
# Duelist Pack: Jaden Yuki 3 Special Edition
# Duelist Pack: Jesse Anderson Special Edition
# Duelist Pack: Yusei Fudo 3 Special Edition
# Duelist Pack: Crow Special Edition
# Duelist Pack: Yugi Special Edition
# Starter Deck 2006: Special Edition Promos
Starter Deck 2007 Special Set	(OCG-JP)	2
# Starter Deck 2011: Special Edition
# Next-Gen Dueling Kit
# Starter Deck 2012: Special Edition
Structure Deck: Deluxe Set	(OCG-JP)	2
Structure Deck: Deluxe Set Volume 2	(OCG-JP)	2
Structure Deck: Dinosaur's Rage Special Edition	(OCG-JP)	2
Structure Deck: Machine Re-Volt Special Edition	(OCG-JP)	2
Structure Deck: Surge of Radiance Special Edition	(OCG-JP)	2
# Structure Deck: Lord of the Magician Limited Edition
Structure Deck: Special Set	(OCG-KR)	2
Structure Deck: Special Set 2	(OCG-KR)	2
Structure Deck: Warrior's Triump Special Edition	(OCG-KR)	2
Structure Deck: Spellcaster's Judgment Specail Edition	(OCG-KR)	2
Structure Deck: Revival of the Great Dragon Special Edition	(OCG-KR)	2
Structure Deck: Lord of the Storm Deluxe Set	(OCG-KR)	2
Structure Deck: Dinosaur's Rage Special Edition	(OCG-KR)	2
Structure Deck: Machine Re-Volt Special Edition	(OCG-KR)	2
Structure Deck: Undead World Family Edition	(OCG-KR)	2
Structure Deck: Dragunity Drive Special Edition	(OCG-KR)	2
Structure Deck: Roar of the Sea Emperor Special Edition	(OCG-KR)	2
Structure Deck: The Blue-Eyed Dragon's Thundering Descent Special Edition	(OCG-KR)	2
Structure Deck: Cyber Dragon Revolution Deluxe Edition	(OCG-KR)	2
# Deluxe Edition Structure Deck Promotional Cards
Structure Deck: Dinosaur's Rage Special Set	(TCG-EN)	0
Forbidden Legacy	(TCG-EN)	0
# Ultimate Edition
# Ultimate Edition 2
# Yu-Gi-Oh! GX Special Edition
# Light and Darkness Power Pack
# Twilight Edition
# X-Saber: Special Edition
# X-Saber Power-Up
# Samurai Assault
# Stardust: Special Edition
EX-Premium Pack: Special Edition	(OCG-KR)	2
# Ex.Premium Pack Kit Vol 1
# Ex.Premium Pack Kit Vol 2
# Ex.Premium Pack Kit Vol 3
# Yu-Gi-Oh! OCG Duelist Box
Duelist Set: DX Double Union	(OCG-JP)	2
# Dragunity Blast
# Utopia Value Box
Master Hyperion Value Box	(TCG-EN)	0
Shadow Samurai Value Box	(TCG-EN)	0
Poseidra Value Box	(TCG-EN)	0
Silver Dragon Value Box	(TCG-EN)	0
Machine Madness Value Box	(TCG-EN)	0
Fire Fists: Special Edition	(TCG-EN)	0
Tournament Pack 2007 Vol.1	(OCG-JP)	2
Tournament Pack 2007 Vol.2	(OCG-JP)	2
Tournament Pack 2007 Vol.3	(OCG-JP)	2
Tournament Pack 2007 Vol.4	(OCG-JP)	2
Tournament Pack 2008 Vol.1	(OCG-JP)	2
Tournament Pack 2008 Vol.2	(OCG-JP)	2
#Tournament Pack 2008 Vol.3	(OCG-JP)	2
#Tournament Pack 2008 Vol.4	(OCG-JP)	2
Tournament Pack 2009 Vol.1	(OCG-JP)	2
Tournament Pack 2009 Vol.2	(OCG-JP)	2
Tournament Pack 2009 Vol.3	(OCG-JP)	2
#Tournament Pack 2009 Vol.4	(OCG-JP)	2
#Tournament Pack 2010 Vol.1	(OCG-JP)	2
#Tournament Pack 2010 Vol.2	(OCG-JP)	2
#Tournament Pack 2010 Vol.3	(OCG-JP)	2
#Tournament Pack 2010 Vol.4	(OCG-JP)	2
#Tournament Pack 2011 Vol.1	(OCG-JP)	2
#Tournament Pack 2011 Vol.2	(OCG-JP)	2
#Tournament Pack 2011 Vol.3	(OCG-JP)	2
#Tournament Pack 2011 Vol.4	(OCG-JP)	2
#Tournament Pack 2012 Vol.1	(OCG-JP)	2
Tournament Pack 2012 Vol.2	(OCG-JP)	2
Tournament Pack 2012 Vol.3	(OCG-JP)	2
Advanced Tournament Pack 2013 Vol.1	(OCG-JP)	2
Advanced Tournament Pack 2013 Vol.2	(OCG-JP)	2
Advanced Tournament Pack 2013 Vol.3	(OCG-JP)	2
Advanced Tournament Pack 2013 Vol.4	(OCG-JP)	2
Advanced Tournament Pack 2014 Vol.1	(OCG-JP)	2
Advanced Tournament Pack 2014 Vol.2	(OCG-JP)	2
Advanced Tournament Pack 2014 Vol.3	(OCG-JP)	2
Tournament Pack 2010 Vol.6	(OCG-KR)	2
Advanced Event Pack 2014 Vol.1	(OCG-KR)	2
Advanced Event Pack 2014 Vol.2	(OCG-KR)	2
Tournament Pack: 1st Season	(TCG-NA)	0
Tournament Pack: 2nd Season	(TCG-NA)	0
Tournament Pack: 3rd Season	(TCG-NA)	0
Tournament Pack 4	(TCG-NA)	0
Tournament Pack 5	(TCG-EN)	0
Tournament Pack 6	(TCG-EN)	0
Tournament Pack 7	(TCG-EN)	0
Tournament Pack 8	(TCG-EN)	0
Champion Pack: Game One	(TCG-EN)	0
Champion Pack: Game Two	(TCG-EN)	0
Champion Pack: Game Three	(TCG-EN)	0
Champion Pack: Game Four	(TCG-EN)	0
Champion Pack: Game Five	(TCG-EN)	0
Champion Pack: Game Six	(TCG-EN)	0
Champion Pack: Game Seven	(TCG-EN)	0
Champion Pack: Game Eight	(TCG-EN)	0
#Turbo Pack: Booster One
#Turbo Pack: Booster Two
#Turbo Pack: Booster Three
Turbo Pack: Booster Four	(TCG-EN)	0
Turbo Pack: Booster Five	(TCG-EN)	0
#Turbo Pack: Booster Six	(TCG-EN)	0
Turbo Pack: Booster Seven	(TCG-EN)	0
Turbo Pack: Booster Eight	(TCG-EN)	0
Astral Pack One	(TCG-EN)	0
Astral Pack Two	(TCG-EN)	0
Astral Pack Three	(TCG-EN)	0
Astral Pack Four	(TCG-EN)	0
Astral Pack Five	(TCG-EN)	0
# GameBoy Duel Monsters Promos Series 1
# GameBoy Duel Monsters Promos Series 2
# GameBoy Duel Monsters Promos Series 3
# GameBoy Duel Monsters Promos Series 4
# GameBoy Duel Monsters Promos Series 5
# GameBoy Duel Monsters Promos Series 6
# GameBoy Duel Monsters Promos Series 7
# GameBoy Duel Monsters Promos Series 8
Yu-Gi-Oh! Dark Duel Stories promotional cards	(TCG-EN)	0
Yu-Gi-Oh! The Eternal Duelist Soul promotional cards	(TCG-NA)	0
Yu-Gi-Oh! The Sacred Cards promotional cards	(TCG-NA)	0
Yu-Gi-Oh! Reshef of Destruction promotional cards	(TCG-NA)	0
#Reshef of Destruction and The Sacred Cards Doublepack promotional cards
Gameboy Worldwide Edition	(OCG-JP)	2
Yu-Gi-Oh! Worldwide Edition: Stairway to the Destined Duel promotional cards	(TCG-NA)	0
# Duel Monsters Expert 3 Promos
Yu-Gi-Oh! World Championship Tournament 2004 promotional cards	(TCG-NA)	0
Yu-Gi-Oh! Destiny Board Traveler promotional cards	(TCG-EN)	0
# Gameboy Worldwide Edition 2 promotional cards
Yu-Gi-Oh! 7 Trials to Glory: World Championship Tournament 2005 promotional cards	(TCG-EN)	0
Yu-Gi-Oh! GX Duel Academy promotional cards	(TCG-EN)	0
# Duel Monsters Expert 2006 Promot Set
Yu-Gi-Oh! Ultimate Masters: World Championship Tournament 2006 promotional cards	(TCG-EN)	0
Yu-Gi-Oh! Nightmare Troubadour promotional cards	(TCG-EN)	0
Yu-Gi-Oh! GX Spirit Caller promotional cards	(TCG-EN)	0
Yu-Gi-Oh! World Championship 2007 promotional cards	(TCG-EN)	0
Yu-Gi-Oh! GX Card Almanac promotional cards	(TCG-EN)	0
Yu-Gi-Oh! World Championship 2008 promotional cards	(TCG-EN)	0
Yu-Gi-Oh! 5D's Stardust Accelerator promotional cards	(TCG-EN)	0
Yu-Gi-Oh! 5D's Reverse of Arcadia Promotional Cards	(TCG-EN)	0
# Yu-Gi-Oh! 5D's World Championship 2011: Over the Nexus promotional cards
Yu-Gi-Oh! ZEXAL World Duel Carnival promotional cards	(TCG-EN)	0
# Yu-Gi-Oh! The Falsebound Kingdom Promotional Cards
# Yu-Gi-Oh! Wheelie Breakers Promotional Cards
# Yu-Gi-Oh! 5D's Duel Transer Promotional Cards
# Power of Chaos Promos: Yugi the Destiny
Yu-Gi-Oh! Power of Chaos: Kaiba the Revenge promotional cards	(TCG-NA)	0
# Power of Chaos Promos: Joey the Passion
# PlayStation True Duel Monsters Promos: Series 1
# Yu-Gi-Oh! Forbidden Memories Promotional Cards
# PlayStation True Duel Monsters Promos: Series 2
Yu-Gi-Oh! The Duelists of the Roses promotional cards	(TCG-NA)	0
Yu-Gi-Oh! Capsule Monster Coliseum promotional cards	(TCG-EN)	0
# Yu-Gi-Oh! GX Tag Force Evolution promotional cards
# Yu-Gi-Oh! GX Tag Force Promotional Cards
# Yu-Gi-Oh! GX Tag Force 2 Promotional Cards
# Yu-Gi-Oh! GX Tag Force 3 Promotional Cards
# Yu-Gi-Oh! GX Tag Force 4 Promotional Cards
# Yu-Gi-Oh! GX Tag Force 5 Promotional Cards
# Yu-Gi-Oh! GX Tag Force 6 Promotional Cards
# Yu-Gi-Oh! The Dawn of Destiny Promotional Cards
Limited Edition	(OCG-JP)	2
Limited Edition 2	(OCG-JP)	2
Limited Edition 3	(OCG-JP)	2
# Limited Edition 4
# Limited Edition 5
# Limited Edition 6
# Limited Edition 7
# Limited Edition 8
# Limited Edition 9
# Limited Edition 10
# Limited Edition 11
Limited Edition 12	(OCG-JP)	2
Limited Edition 13	(OCG-JP)	2
# Limited Edition 14
# Limited Edition 15
# Limited Edition 16
# Limited Edition 17
V Jump Edition	(OCG-JP)	2
V Jump Edition 2	(OCG-JP)	2
V Jump Edition 3	(OCG-JP)	2
V Jump Edition 4	(OCG-JP)	2
V Jump Edition 5	(OCG-JP)	2
V Jump Edition 6	(OCG-JP)	2
V Jump Edition 7	(OCG-JP)	2
V Jump Edition 8	(OCG-JP)	2
V Jump Edition 9	(OCG-JP)	2
V Jump Edition 10	(OCG-JP)	2
V Jump Edition 11	(OCG-JP)	2
